12111131
10000101
11110101
10000101
10111100
10100010
10101010
10001000