2100010001
0101010103
0101010111
0101010000
0101011110
0001010000
4444010111
4444010000
4444011110
4444000000