00023000
01111110
00011000
11011011
11011011
00011000
01111110
00000000